0,o,2,3,4,5,6,7,8,9
0,1,2,3,4,5,6,7,d,9
0,1,2,*,4,5,*,*,*,*
0,1,2,*,4,5,6,7,8,9
0,1,2,*,4,5,6,7,8,9
*,*,*,*,*,5,*,*,*,*
0,1,2,3,4,5,6,7,8,9
0,*,*,3,4,*,*,7,*,9
0,1,2,3,4,*,6,o,8,9
r,1,2,3,4,*,6,7,8,9